駅音ふみ	エキネフミ
きれぼしJAPAN	キレボシジャパン
英翠韻製蘭	エイスイインセイラン
アルミニウム	アルミニウム
エージェ	エージェ
PlayStation VR	プレイステーションヴィーアール
JCB	ジェイシービー
英翠韻造茉	エイスイインゾウマ
詠歌サチ	エイカサチ
詠歌キョイル	エイカキョイル
Forza Horizon 3	フォルツァホライゾンスリー
伊福部崇のラジオのラジオ	イフクベタカシノラジオノラジオ
虚音イフ	ウロネイフ
茅野愛衣	カヤノアイ
閏月ナコ	ウルウヅキナコ
アンツィオ	アンツィオ
安元洋貴	ヤスモトヒロキ
くろくも	クロクモ
ニコニコ動画で配信中のアニメ作品一覧	ニコニコドウガデハイシンチュウノアニメサクヒンイチラン
ブラザーコンプレックス	ブラザーコンプレックス
エミヤ系女子	エミヤケイジョシ
ぽっくん	ポックン
東京タワー	トウキョウタワー
林原めぐみのHeartful Station	ハヤシバラメグミノハートフルステーション
UP'S	アップス
事件・事故の一覧	ジケンジコノイチラン
ペペ（ポルトガルのサッカー選手）	ペペポルトガルノサッカーセンシュ
セルヒオ・アグエロ	セルヒオアグエロ
アンヘル・ディ・マリア	アンヘルディマリア
樹人(utau)	ジュト
秋元羊介	アキモトヨウスケ
王泥喜法介	オドロキホウスケ
森本貴幸	モリモトタカユキ
クリスティアーノ・ロナウド	クリスティアーノロナウド
成田湯川駅	ナリタユカワエキ
アリーナ(ドラゴンクエスト)	アリーナ
佐久間まゆ	サクママユ
Spec Ops: The Line	スペックオプスザライン
瓜音ウリ	ウリネウリ
李舜臣	リシュンシン
エロゲのタイトル一覧	エロゲノタイトルイチラン
海麗	ウララ
梅兎	ウメト
海音ナツキ	ウミネナツキ
海音コウ	ウミネコウ
馬歌麻呂	ウマカマロ
卯音シヨ	ウネシヨ
Uったんぽいで	ウッタンポイデ
鬱多シノ	ウツダシノ
ヤキモチストリーム	ヤキモチストリーム
写音みゅ	ウツスネミュ
おジャ魔女どれみ	オジャマジョドレミ
写音しぅ	ウツスネシゥ
雨月(UTAU)	ウヅキ
歌造ツバメ・ツツジ	ウタノミヤツコツバメツツジ
ジョゼフ・ゴードン=レヴィット	ジョセフゴードンレヴィット
TBSラジオ	ティービーエスラジオ
詩音マコト	ウタノネマコト
ミャンマー	ミャンマー
歌十言葉・歌金魚	ウタトコトノハウタガネサカナ
UTA戦死	ウタセンシ
一覧の一覧	イチランノイチラン
唄世ウカ・恵禾エオ	ウタセウカケイカエオ
男優の一覧	ダンユウノイチラン
闇金ウシジマくん	ヤミキンウシジマクン
歌う音クル	ウタウネクル
雨廻ツブリ	ウカイツブリ
風と共に去りぬ	カゼトトモニサリヌ
集団的自衛権	シュウダンテキジエイケン
世界樹の迷宮V 長き神話の果て	セカイジュノメイキュウファイブナガキシンワノハテ
Vista(UTAU)	ヴィスタ
ゴースト・ドッグ	ゴーストドック
ナイト・オブ・ザ・スカイ	ナイトオブザスカイ
ポケモンの関連項目一覧	ポケモンノカンレンコウモクイチラン
映画の一覧	エイガノイチラン
トップガン	トップガン
ドッグファイト	ドッグファイト
料理の天災	リョウリノテンサイ
CR哲也～雀聖と呼ばれた男～	シーアールテツヤジャンセイトヨバレタオトコ
鳩ろだ。	ハトロダ
タワーオブグレー	タワーオブグレー
ゆっくり実況プレイ最終回リンク	ユックリジッキョウプレイサイシュウカイリンク
ガスタ	ガスタ
コトブキヤ	コトブキヤ
ジョン・ボウカー	ジョンボウカー
ビートたけしのTVタックル	ビートタケシノテレビタックル
漆黒のシャルノス	シッコクノシャルノス
ポケモンAGneXtのサブキャラクター紹介	ポケモンエージーネクストノサブキャラクターショウカイ
Yahoo!知恵袋	ヤフーチエブクロ
いぇふ(絵師)	イェフ
モナド(プログラミング)	プログラミングニオケルモナド
ぼくのなつやすみ3	ボクノナツヤスミスリー
かまってちゃん	カマッテチャン
甲種勲章	コウシュクンショウ
ぼからんの門番	ボカランノモンバン
甲鉄城のカバネリ	コウテツジョウノカバネリ
グランツーリスモSPORT	グランツーリスモスポーツ
クッキー☆	クッキー
ベルセルク無双	ベルセルクムソウ
2000シリーズ	ニセンシリーズ
人喰いの大鷲トリコ	ヒトクイノオオワシトリコ
銀河英雄伝説	ギンガエイユウデンセツ
ユリウス・エルスハイマー	ユリウスエルスハイマー
硲道夫	ハザマミチオ
ハロー!プロジェクト	ハロープロジェクト
くろーばー	クローバー
境界線上のホライゾン・補足資料	キョウカイセンジョウノホライゾンホソクシリョウ
SUMMER LESSON	サマーレッスン
盤上のシンデレラ	バンジョウノシンデレラ
ハイスクール・フリート	ハイスクールフリート
広田空	ヒロタソラ
アニメ作品一覧	アニメサクヒンイチラン
Hearts of Iron IV	ハーツオブアイアンフォー
こげぱん	コゲパン
【ゆっくり】幻想人形演舞アペンド版を東方五大老でクリアしたい	ユックリゲンソウニンギョウエンブアペンドバンヲトウホウゴタイロウデクリアシタイ
としまえん	トシマエン
コケ	コケ
本日の萌絵	ホンジツノモエ
MTAT戦争	マニュアルオートマセンソウ
RI(歌い手)	アールアイ
焼肉	ヤキニク
長き童貞	ナガキドウテイ
オニオンリング	オニオンリング
ひみつきち	ヒミツキチ
セビージャFC	セビージャエフシー
犬丸芝居小屋	イヌマルシバイゴヤ
機動警察パトレイバー	キドウケイサツパトレイバー
北尾まどか	キタオマドカ
KAITO	カイト
片上大輔	カタガミダイスケ
メタルギアソリッドⅤ ザ・ファントム・ペイン	メタルギアソリッドファイブザファントムペイン
CV:坂本真綾	シーブイサカモトマアヤ
ビタミンC	ビタミンシー
贋金と天秤	ガンキントテンビン
i love u@あいり	アイラアブユーアイリ
杵崎姉妹	キネサキシマイ
連射太郎	レンシャタロウ
ジ・オーダー・グランデ	ゾーイ
ポケットモンスターサン・ムーン	ポケットモンスターサンムーン
傷物語	キズモノガタリ
石川竜太郎	ショダイチャントシテタイシ
〈物語〉シリーズ	モノガタリシリーズ
CINDERELLA PARTY!	シンデレラパーティー
今週のニコニコ大百科 HOTワード	コンシュウノニコニコダイヒャッカホットワード
パカパカパッション	パカパカパッション
暦物語	コヨミモノガタリ
社会保険	シャカイホケン
藤井隆	フジイタカシ
レオニダス	レオニダス
テスト記事	テストキジ
アイドルマスターのプロデューサーの一覧	アイドルマスターノプロデューサーノイチラン
春日未来	カスガミライ
バスマットP	バスマットピー
野間易通	ノマヤスミチ
くるくる(くるくる星人)	クルクルカッコクルクルセイジン
有田芳生	アリタヨシフ
フィルトウィズオンライン	フィルトウィズオンライン
リダイレクト記事の一覧	リダイレクトキジノイチラン
北海道	ホッカイドウ
ミリオン予備軍(再生数)	ミリオンヨビグンサイセイスウ
ミリオン統計データ(再生数編)	ミリオントウケイデータサイセイスウヘン
100万再生	ヒャクマンサイセイ
&gt;&gt;3が理解できることが不幸	サンガリカイデキルコトガフコウ
ふらいんぐうぃっち	フライングウィッチ
サックス(銀河英雄伝説)	サックス
朱の孤塔のエアゲトラム	アケノコトウノエアゲトラム
小松未可子	コマツミカコ
仮面ライダーFate	カメンライダーフェイト
迷列車(海外)の人	メイレッシャカイガイノヒト
小島秀夫	コジマヒデオ
水虫	ミズムシ
MasterCard	マスターカード
双星の陰陽師	ソウセイノオンミョウジ
カビ	カビ
再保険	サイホケン
クレジットカード	クレジットカード
ねねし	ネネシ
B-17	ビージュウナナ
パンツァーフロント	パンツァーフロント
ブラック企業	ブラックキギョウ
ハリアーP	ハリアーピー
電車内でJKがダベるだけのヤツ。	デンシャナイデジェーケーガダベルダケノヤツ
ファーリーの鋳物工場	ファーリーノイモノコウジョウ
社会保障	シャカイホショウ
艦娘	カンムス
伊吹翼	イブキツバサ
ツツケラ	ツツケラ
ALC一派	アリスイッパ
戦艦ハルバード	センカンハルバード
SKRNBU姉貴	サクランボウ
アガートラーム	アガートラーム
アガートラーム	アガートラーム
呪い子	ノロイコ
ポケモンずかん	ポケモンズカン
デビットカード	デビットカード
マギアナ	マギアナ
仮面ライダーアマゾンズ	カメンライダーアマゾンズ
生活協同組合	セイカツキョウドウクミアイ
宣伝部田中	センデンブタナカ
仮面ライダーゴースト	カメンライダーゴースト
キズナイーバー	キズナイーバー
ヤヤコマ	ヤヤコマ
アゴジムシ	アゴジムシ
仮面ライダードライブ	カメンライダードライブ
MOVIE大戦	ムービータイセン
真島吾朗	マジマゴロウ
ヤングース	ヤングース
ぷちデレラ	プチデレラ
ガンダムAGE-FX	ガンダムエイジエフエックス
自分で書けない人のための記事作成依頼	ジブンデカケナイヒトノタメノキジサクセイイライ
医者が黙って首を横に振るシリーズ	イシャガダマッテクビヲヨコニフルシリーズ
青嶋達也	アオシマバクシンオー
mtu	エムティーユー
セクレタリアト	ウマノヨウナナニカ
ケツでしょ。	ケツデショ
狭心症	キョウシンショウ
万丈目サンダー	マンジョウメサンダー
銀河へキックオフ!!	ギンガヘキックオフ
オッペラスッチョンコーポレーション	オッペラスッチョンコーポレーション
弱酸性ミリオンアーサー	ジャクサンセイミリオンアーサー
悪いけどこの動画３人用なんだ	ワルイケドコノドウガサンニンヨウナンダ
水樹奈々	ミズキナナ
なんっ…でそこまで!的確に人を傷つける台詞が言えるんだよお前はあああああっ!!	ナンッデソコマデテキカクニヒトヲキズツケルセリフガイエルンダヨオマエハアアアアアッ
NX(任天堂新ハードの仮称)	エヌエックス
ドラゴンクエスト	ドラゴンクエスト
井伊直平	イイナオヒラ
はるふり	ハルフリ
成歩堂みぬき	ナルホドウミヌキ
安川純平	ヤスカワジュンペイ
グフ	グフ
ポケモンの記事のテンプレ	ポケモンノキジノテンプレ
ASEAN	アセアントウナンアジアショコクレンゴウ
ぼくのなつやすみ4	ボクノナツヤスミヨン
ジョジョの奇妙な冒険	ジョジョノキミョウナボウケン
高原直泰	タカハラナオヒロ
ファイナルファンタジーXV	ファイナルファンタジーフィフティーン
カスター(実況プレイヤー)	カスター
フォレスト・ウィテカー	フォレストウィテカー
鹿児島交通	カゴシマコウツウ
クラピカ('A`)	クラピカソノーマーマーデイイー
文豪ストレイドッグス	ブンゴウストレイドッグス
アイルトンシンボリ	アイルトンシンボリ
ゼルダの伝説 ブレス オブ ザ ワイルド	ゼルダノデンセツブレスオブザワイルド
○ ○ ス ト ー ム シリーズ	マルマルストームシリーズ
ブルーベリーシリーズ	ブルーベリーシリーズ
三者三葉	サンシャサンヨウ
くまみこ	クマミコ
はじめての三国志	ハジメテノサンゴクシ
野獣先輩	ヤジュウセンパイ
ボロディン	ボロディン
金元寿子	カネモトヒサコ
そせじ番長	ソセジバンチョウ
殺人	サツジン
アブナー・アブレイユ	アブナーアブレイユ
萬谷康平	マンタニコウヘイ
ゼルダの伝説	ゼルダノデンセツ
こゑだ	コエダ
旅客機	リョカクキ
peimame	ペイマメ
UTAUキャラクターのお絵カキコ	ウタウキャラクターノオエカキコ
UTAU音声ライブラリ一覧	ウタウオンセイライブラリイチラン
GODZILLA（2014）	ゴジラ
インディゴ音ペン	インディゴネペン
印綬音ミドリ	インジュネミドリ
妹音ルン	イモネルン
今音ムイ	イマネムイ
今歌サラ	イマカサラ
伊予苑黒壱	イヨソノクロイチ
祈音ユダ	イノリネユダ
祈音イヴ	イノリネイヴ
Lastrum	ラストラム
いぬへび・犬歌イチ	イヌヘビイヌガイチ
一色茉莉	イッシキマツリ
凍弦トーカ	イツルトーカ
一岡竜司	イチオカリュウジ
一条（UTAU）	イチジョウ
伊佐田っぽいし	イサダッポイシ
イイキ声	イイキコエ
歌う音ナミ・育音レン	ウタウネナミイクネレン
球速	キュウソク
有音ロク	アリネロク
彩鞠えのん	アヤマリエノン
レディバ	レディバ
彩鞠えとわ	アヤマリエトワ
トリプルスリー	トリプルスリー
彩鞠えそら	アヤマリエソラ
綾音偲	アヤネシノブ
雨音ケミ	アメネケミ
飴音狼・毒音イウ	アメネロウドクネイウ
愛未（UTAU）	アミ
天宮光	アマミヤヒカリ
阪和線	ハンワセン
鎌月鈴乃	カマヅキスズノ
天音ルナ	アマネルナ
甘音チビ	アマネチビ
天月りよん	アマツキリヨン
甘く音マユ	アマクネマユ
MMD刀剣乱舞	エムエムディートウケンランブ
アマガク	アマガク
花鶏音ひわ	アトリネヒワ
安心院エメ	アジムエメ
浅花リヨウ	アサハナリヨウ
朱音イナリ	アカネイナリ
愛野ハテ	アイノハテ
藍葵アオ	アイキアオ
瞬間!ニコニコ大百科アーカイブズ	シュンカンニコニコダイヒャッカアーカイブズ
緋惺	アケサト
等松美海	トウマツミミ
成歩堂	ナルホドウ
アクア(踊り手)	アクア
剛力彩芽	ゴウリキアヤメ
なんでや！阪神関係ないやろ！	ナンデヤハンシンカンケイナイヤロ
四国安全都市宣言	シコクアンゼントシセンゲン
スラッシュアックスF	スラッシュアックスエフ
Mac OS	マックオーエス
るなちゅ	ルナチュ
二二・六事件	ニニロクジケン
女神天国	メガミパラダイス
今週の扉絵	コンシュウノトビラエ
macOS	マックオーエス
宇田慧	ウダメグミ
ハンドレッド	ハンドレッド
フライングジラフ	フライングジラフ
VF-17	ブイエフセブンティーンナイトメア
ネタのデススタック	ネタノデススタック
GPSS	ジーピーエスエス
新田恵海	エミツン
シンデレラ一門	シンデレライチモン
機装ルーガ	キソウルーガ
空音蘭	アクオトラン
翠乃マドリガーレ	アキノマドリガーレ
雨音静流	アマネシズル
ヴィルヘルミーナ・ブラウンシュヴァイク・インゲノール・フリーデブルク	ヴィルヘルミーナブラウンシュヴァイクインゲノールフリーデブルク
天月しょう	アマツキショウ
万守トリム	アラストリム
紅音きぃ	アカネキィ
アラブ首長国連邦	アラブシュチョウコクレンポウ
登山家	トザンカ
魔法少女まどか☆マギカ[魔獣編]	マホウショウジョマドカマギカマジュウヘン
葵コルリ・オオルリ	アオイコルリオオルリ
まんがタイムきらら☆マギカ	マンガタイムキララマギカ
アタック（UTAU）	アタック
鏑木美波	カブラギミナミ
ホセ・ロペス	ホセロペス
リック・ウェイクマン	リックウェイクマン
トゲゾー	トゲゾー
明透歌	アスカ
納沙幸子	ノサコウコ
愛琉歌ウェヌ	アイルガウェヌ
立石志摩	タテイシシマ
孫悟飯	ソンゴハン
早坂美玲	ハヤサカミレイ
愛音アノン	アイネアノン
セカンドショット	セカンドショット
紅音ナツ	アカネナツ
VOCALOID伝説入り直前	ボーカロイドデンセツイリチョクゼン
阿井植男	アイウエオ
種田梨沙	タネダリサ
ありぽん(実況プレイヤー)	アリポンジッキョウプレイヤー
MMD東方花映塚モデル	エムエムディートウホウカエイヅカモデル
淫夢関連項目一覧	インムカンレンコウモクイチラン
少年メイド	ショウネンメイド
なかなか出てこなかったよな?	ナカナカデテコナカッタヨナ
そうだよ(便乗)	ソウダヨ
沢城みゆき	サワシロミユキ
トゲゾーこうら	トゲゾーコウラ
るなぽんず	ルナポンズ
星のカービィの関連項目一覧	ホシノカービィノカンレンコウモクイチラン
刀条さゆり	トウジョウサユリ
カードファイト!!ヴァンガードG	カードファイトヴァンガードジー
銀河に名立たるハルトマン	ギンガニナダタルハルトマン
清武弘嗣	キヨタケヒロシ
結(ゆい)	ユイ
桃華れん	モモハナレン
音石明	オトイシアキラ
蝉サブレ	セミサブレ
カードゲームではよくあること	カードゲームデハヨクアルコト
ジーン	ジーン
今週のオススメ記事	コンシュウノオススメキジ
クイズRPG 魔法使いと黒猫のウィズ	クイズアールピージーマホウツカイトクロネコノウィズ
MMD東方永夜抄モデル	エムエムディートウホウエイヤショウモデル
長崎ペンギン水族館	ナガサキペンギンスイゾクカン
手品	テジナ
MMD東方旧作モデル	エムエムディートウホウキュウサクモデル
マイルチャンピオンシップ南部杯	マイルチャンピオンシップナンブハイ
トランセンド	トランセンド
はしれ!コード学園	ハシレコードガクエン
トリプルミリオン予備軍	トリプルミリオンヨビグン
海外の反応アニメシリーズ	カイガイノハンノウアニメシリーズ
東方決闘鉄	トウホウケットウテツ
ダブルミリオン予備軍	ダブルミリオンヨビグン
江花青春	エバナアオハル
ジョジョの奇妙な声優一覧	ジョジョノキミョウナセイユウイチラン
黒鉄博人	クロガネヒロト
100万再生達成動画の一覧(2015年09・10月分)	ヒャクマンサイセイタッセイドウガノイチランニセンジュウゴネンクガツジュウガツブン
うさかめ	ウサカメ
舞浜歩	マイハマアユム
ご注文はうさぎですか？	ゴチュウモンハウサギデスカ
駒形友梨	コマガタユリ
100万再生から削除日までの所要日数（短い順）	ヒャクマンサイセイカラサクジョビマデノショヨウニッスウミジカイジュン
葉桜士道	ハザクラシドウ
徴兵制	チョウヘイセイ
ミリオン英雄墓地	ミリオンエイユウボチ
100万再生から200万再生達成日までの所要日数(遅い順)	ヒャクマンサイセイカラニヒャクマンサイセイマデノショヨウニッスウオソイジュン
200万再生	ニヒャクマンサイセイ
角元明日香	カクモトアスカ
野村香菜子	ノムラカナコ
56	ゴジュウロク
ふもっふOPパロ	フモッフオープニングパロ
武田良太	タケダリョウタ
れみにゃ	レミニャ
アイアンマンヘビーメタル級王座	アイアンマンヘビーメタルキュウオウザ
徳田毅	トクダタケシ
SOUND VOLTEXの譜面制作者(エフェクター)一覧	サウンドボルテックスノフメンセイサクシャエフェクターイチラン
Shovel Knight	ショベルナイト
ねこわかめ	ネコワカメ
永遠の闇	エイエンノヤミ
DDTプロレスリング	ディーディーティープロレスリング
有機vs人参	ユウキバーサスニンジン
箱崎星梨花	ハコザキセリカ
2016年秋アニメ	ニセンジュウロクネンアキアニメ
水瀬いのり	ミナセイノリ
五島慶太	ゴトウケイタ
コジマプロダクション	コジマプロダクション
ワガママハイスペック	ワガママハイスペック
プリパラ 3rd season	プリパラサードシーズン
ネトゲの嫁は女の子じゃないと思った？	ネトゲノヨメハオンナノコジャナイトオモッタ
聖地の一覧	セイチノイチラン
ギャプランTR-5［フライルー］	フライルー
沼津市立長井崎中学校	ヌマヅシリツナガイサキチュウガッコウ
ラブライブ！サンシャイン!!	ラブライブサンシャイン
ラブライブ！サンシャイン!!の関連項目一覧	ラブライブサンシャインノカンレンコウモクイチラン
星の子ポロン	ホシノコポロン
ポアロのあと何分あるの？	ポアロノアトナンプンアルノ
こもわた遙華	コモワタハルカ
だれ?らじ	ダレラジ
暗君	アンクン
マ淫クルルァフト	マインクルルァフト
秋月涼	アキヅキリョウ
学校の一覧	ガッコウノイチラン
豊郷町立豊郷小学校	トヨサトチョウリツトヨサトショウガッコウ
不遇ポケモン	フグウポケモン
古代進	コダイススム
とっとこハム太郎2 ハムちゃんず大集合でちゅ	トットコハムタロウツーハムチャンズダイボウケンデチュ
PROJECT X ZONE	プロジェクトクロスゾーン
白猫プロジェクトのキャラクター一覧	シロネコプロジェクトノキャラクターイチラン
白猫プロジェクト	シロネコプロジェクト
株式会社コンテライド	コンテライド
熊本地震	クマモトジシン
デジターボ	デジターボ
SHOUTICE	ショウチス
すねこすり(utau)	スネコスリ
ぷりむ	プリム
アージュ	アージュ
Forza Motorsport	フォルツァモータースポーツ
ワールド オブ ファイナルファンタジー	ワールドオブファイナルファンタジー
グッドスマイルカンパニー	グッドスマイルカンパニー
未来検索ブラジル	ミライケンサクブラジル
アース・スター エンターテイメント	アーススターエンターテイメント
オーバーラップ	オーバーラップ
ファミリーマート	ファミリーマート
Cygames	サイゲームス
315プロNight!	サイコープロナイト
ドワンゴ	ドワンゴ
株式会社ニワンゴ	カブシキガイシャニワンゴ
バンダイナムコホールディングス	バンダイナムコホールディングス
HAL研究所	ハルケンキュウジョ
ゆっくり華扇とぶち破るダブルクロス	ユックリカセントブチヤブルダブルクロス
美しい魔闘家鈴木	ウツクシイマトウカスズキ
ボカロクラシカ納涼祭	ボカロクラシカノウリョウマツリ
寿司	スシ
こいかぜ	コイカゼ
アイドルマスターのゲーム登場曲の一覧	アイドルマスターノゲームトウジョウキョクノイチラン
WMM-E	ダブリューエムエムイー
アメリカンページワン	アメリカンページワン
